0000mm00m0m0mm0
mmm0mmm0m0000m0
mm00mm0000mmm00
000mm000m00m00m
mm0000mm00000mm
mm00mmm00m00mmm
m0000mmm0000m00
m00m00m00m0m00m
000m000m00000mm
00m00mm000mm000
mm000000mm000mm
000mm00m000mm00
mm0000mm0m0000m
mmmm00000mmm000
mm000mmmm00000f